2222222222222211
0000000000000011
0000000000000011
0000000000000011
0000000000000011
0000000000000011
0000000000000011
0000000000000011
0000000000000011
0000000000000011
0000000000000011
0000000000000011
0000000000000011
0000000000000011
0000000000000011
0000000000400011
0000000000000011
0000000000000011
0000000000000011
0000000000100011
0000000000400011
0000004000100011
0000000000400011
0000000000100011
0000000000000011
0000000000000011
0000000000000011
0000000000004411
0000000000004411
0000000000000011
0000000000000011
0000000000000011
0000000000000011
0000000000000011
0000000000000011
0000000000000011
0000000000000011
0000000000044411
0000000000044411
0000000000000011
0000000000000011
0000000000000011
0000000000000011
0000000000000011
0000000000000011
0000000000444411
0000000000444411
0000000000000011
0000000000000011
0000000000000011
0000000000000011
0000000000000011
0000000000000011
0000000000000011
0000000000000011
0000000000344411
0000000000344411
0000000000000011
0000000000000011
0000000000000011
0000000000000011
0000000000000011
0000000002000011
0000000000000011
0000000000000011
0000000000000011
0000000000000011
0000000000000011
0000000000000000
0000000000000000
0000000000000011
0000000000000011
0000000000000011
0000000000000011
0000000000000011
0000000000000011
0000000000100011
0000000000400011
0000000000100011
0000001000000011
0000001000000011
0000001000000011
0000001000000011
0000001000000011
0000001000000011
0000001000000011
0000001000000000
0000001000000000
0000000000000000
0000000000000011
0000000000000011
0000001000000011
0000001000000011
0000001000000011
0000004000100011
0000000000000011
0000000000000011
0000000000000011
0000000000000011
0000000000100011
0000000000100011
0000000000000011
0000000000000011
0000000000000011
0000000000000011
0000000000400011
0000000000000011
0000000000000011
0000000400400011
0000000000000011
0000000000000011
0000000000400011
0000000000000011
0000000000000011
0000000000000011
0000000000000011
0000000000000011
0000000000100011
0000000000000011
0000000000000011
0000001000000011
0000001000000011
0000001000000011
0000000000000011
0000000000000011
0000000000000011
0000000000000011
0000001000000011
0000004000100011
0000004000100011
0000001000000011
0000000000000011
0000000000000011
0000000000000111
0000000000001111
0000000000011111
0000000000111111
0000000000000011
0000000000000011
0000000000111111
0000000000011111
0000000000001111
0000000000000111
0000000000000011
0000000000000011
0000000000000011
0000000000000011
0000000000000111
0000000000001111
0000000000011111
0000000000111111
0000000000111111
0000000000000000
0000000000000000
0000000000111111
0000000000011111
0000000000001111
0000000000000111
0000000000000011
0000000000000011
0000000000000011
0000000000000011
0000000000003411
0000000000003411
0000000000000011
0000000000000011
0000000000000011
0000000000000011
0000000000010011
0000000000010011
0000000000040011
0000000000010011
0000000000000011
0000000000000011
0000000000000011
0000000000000011
0000000000000011
0000000000000011
0000000000000011
0000000000004411
0000000000004411
0000000000000111
0000000000001111
0000000000011111
0000000000111111
0000000001111111
0000000011111111
0000000111111111
0000001111111111
0000001111111111
0000000000000011
0000000000000011
0000000000000011
0000000000000011
0000000000000011
0000000000000011
0000000000000011
0000000000000011
0004444444444111
0000000000000011
0000000000000011
0000000000000011
0000000000000011
0000000000000011
0000000000000011
0000000000000011
0000000000000011
0000000000000011
0000000000000011
0000000000000011
0000000000000011
0000000000000011
0000000000000011
0000000000000011
0000000000000011
0000000000000011
0000000000000011
0000000000000011
0000000000000011
0000000000000011
0000000000000011
0000000000000011
0000000000000011
0000000000000011
0000000000000011
0000000000000011
0000000000000011
0000000000000011
0000000000000011
0000000000000011
0000000000000011
0000000000000011
0000000000000011
0000000000000011
0000000000000011
0000000000000011
0000000000000011
0000000000000011
0000000000000011
0000000000000011
0000000000000011
0000000000000011
0000000000000011
0000000000000011
0000000000000011
0000000000000011
0000000000000011
0000000000000011
0000000000000011
0000000000000011
0000000000000011
0000000000000011
0000000000000011
0000000000000011
0000000000000011
0000000000000011
